0-------0-------0-------0-------0-------0-------0-------0-------0-------0-------0-------0-------0-------0-------0-------0-------
|+------|+------|+------|+------|+------|+------|+------|+------|+------|+------|+------|+------|+------|+------|+------|+------
||+-----||+-----||+-----||+-----||+-----||+-----||+-----||+-----||+-----||+-----||+-----||+-----||+-----||+-----||+-----||+-----
|||+----|||+----|||+----|||+----|||+----|||+----|||+----|||+----|||+----|||+----|||+----|||+----|||+----|||+----|||+----|||+----
||||+---||||+---||||+---||||+---||||+---||||+---||||+---||||+---||||+---||||+---||||+---||||+---||||+---||||+---||||+---||||+---
|||||+--|||||+--|||||+--|||||+--|||||+--|||||+--|||||+--|||||+--|||||+--|||||+--|||||+--|||||+--|||||+--|||||+--|||||+--|||||+--
||||||+-||||||+-||||||+-||||||+-||||||+-||||||+-||||||+-||||||+-||||||+-||||||+-||||||+-||||||+-||||||+-||||||+-||||||+-||||||+-
|||||||0|||||||1|||||||2|||||||3|||||||4|||||||5|||||||6|||||||7|||||||8|||||||9|||||||A|||||||B|||||||C|||||||D|||||||E|||||||F
1-------1-------1-------1-------1-------1-------1-------1-------1-------1-------1-------1-------1-------1-------1-------1-------
|+------|+------|+------|+------|+------|+------|+------|+------|+------|+------|+------|+------|+------|+------|+------|+------
||+-----||+-----||+-----||+-----||+-----||+-----||+-----||+-----||+-----||+-----||+-----||+-----||+-----||+-----||+-----||+-----
|||+----|||+----|||+----|||+----|||+----|||+----|||+----|||+----|||+----|||+----|||+----|||+----|||+----|||+----|||+----|||+----
||||+---||||+---||||+---||||+---||||+---||||+---||||+---||||+---||||+---||||+---||||+---||||+---||||+---||||+---||||+---||||+---
|||||+--|||||+--|||||+--|||||+--|||||+--|||||+--|||||+--|||||+--|||||+--|||||+--|||||+--|||||+--|||||+--|||||+--|||||+--|||||+--
||||||+-||||||+-||||||+-||||||+-||||||+-||||||+-||||||+-||||||+-||||||+-||||||+-||||||+-||||||+-||||||+-||||||+-||||||+-||||||+-
|||||||0|||||||1|||||||2|||||||3|||||||4|||||||5|||||||6|||||||7|||||||8|||||||9|||||||A|||||||B|||||||C|||||||D|||||||E|||||||F
2-------2-------2-------2-------2-------2-------2-------2-------2-------2-------2-------2-------2-------2-------2-------2-------
|+------|+------|+------|+------|+------|+------|+------|+------|+------|+------|+------|+------|+------|+------|+------|+------
||+-----||+-----||+-----||+-----||+-----||+-----||+-----||+-----||+-----||+-----||+-----||+-----||+-----||+-----||+-----||+-----
|||+----|||+----|||+----|||+----|||+----|||+----|||+----|||+----|||+----|||+----|||+----|||+----|||+----|||+----|||+----|||+----
||||+---||||+---||||+---||||+---||||+---||||+---||||+---||||+---||||+---||||+---||||+---||||+---||||+---||||+---||||+---||||+---
|||||+--|||||+--|||||+--|||||+--|||||+--|||||+--|||||+--|||||+--|||||+--|||||+--|||||+--|||||+--|||||+--|||||+--|||||+--|||||+--
||||||+-||||||+-||||||+-||||||+-||||||+-||||||+-||||||+-||||||+-||||||+-||||||+-||||||+-||||||+-||||||+-||||||+-||||||+-||||||+-
|||||||0|||||||1|||||||2|||||||3|||||||4|||||||5|||||||6|||||||7|||||||8|||||||9|||||||A|||||||B|||||||C|||||||D|||||||E|||||||F
3-------3-------3-------3-------3-------3-------3-------3-------3-------3-------3-------3-------3-------3-------3-------3-------
|+------|+------|+------|+------|+------|+------|+------|+------|+------|+------|+------|+------|+------|+------|+------|+------
||+-----||+-----||+-----||+-----||+-----||+-----||+-----||+-----||+-----||+-----||+-----||+-----||+-----||+-----||+-----||+-----
|||+----|||+----|||+----|||+----|||+----|||+----|||+----|||+----|||+----|||+----|||+----|||+----|||+----|||+----|||+----|||+----
||||+---||||+---||||+---||||+---||||+---||||+---||||+---||||+---||||+---||||+---||||+---||||+---||||+---||||+---||||+---||||+---
|||||+--|||||+--|||||+--|||||+--|||||+--|||||+--|||||+--|||||+--|||||+--|||||+--|||||+--|||||+--|||||+--|||||+--|||||+--|||||+--
||||||+-||||||+-||||||+-||||||+-||||||+-||||||+-||||||+-||||||+-||||||+-||||||+-||||||+-||||||+-||||||+-||||||+-||||||+-||||||+-
|||||||0|||||||1|||||||2|||||||3|||||||4|||||||5|||||||6|||||||7|||||||8|||||||9|||||||A|||||||B|||||||C|||||||D|||||||E|||||||F
4-------4-------4-------4-------4-------4-------4-------4-------4-------4-------4-------4-------4-------4-------4-------4-------
|+------|+------|+------|+------|+------|+------|+------|+------|+------|+------|+------|+------|+------|+------|+------|+------
||+-----||+-----||+-----||+-----||+-----||+-----||+-----||+-----||+-----||+-----||+-----||+-----||+-----||+-----||+-----||+-----
|||+----|||+----|||+----|||+----|||+----|||+----|||+----|||+----|||+----|||+----|||+----|||+----|||+----|||+----|||+----|||+----
||||+---||||+---||||+---||||+---||||+---||||+---||||+---||||+---||||+---||||+---||||+---||||+---||||+---||||+---||||+---||||+---
|||||+--|||||+--|||||+--|||||+--|||||+--|||||+--|||||+--|||||+--|||||+--|||||+--|||||+--|||||+--|||||+--|||||+--|||||+--|||||+--
||||||+-||||||+-||||||+-||||||+-||||||+-||||||+-||||||+-||||||+-||||||+-||||||+-||||||+-||||||+-||||||+-||||||+-||||||+-||||||+-
|||||||0|||||||1|||||||2|||||||3|||||||4|||||||5|||||||6|||||||7|||||||8|||||||9|||||||A|||||||B|||||||C|||||||D|||||||E|||||||F
5-------5-------5-------5-------5-------5-------5-------5-------5-------5-------5-------5-------5-------5-------5-------5-------
|+------|+------|+------|+------|+------|+------|+------|+------|+------|+------|+------|+------|+------|+------|+------|+------
||+-----||+-----||+-----||+-----||+-----||+-----||+-----||+-----||+-----||+-----||+-----||+-----||+-----||+-----||+-----||+-----
|||+----|||+----|||+----|||+----|||+----|||+----|||+----|||+----|||+----|||+----|||+----|||+----|||+----|||+----|||+----|||+----
||||+---||||+---||||+---||||+---||||+---||||+---||||+---||||+---||||+---||||+---||||+---||||+---||||+---||||+---||||+---||||+---
|||||+--|||||+--|||||+--|||||+--|||||+--|||||+--|||||+--|||||+--|||||+--|||||+--|||||+--|||||+--|||||+--|||||+--|||||+--|||||+--
||||||+-||||||+-||||||+-||||||+-||||||+-||||||+-||||||+-||||||+-||||||+-||||||+-||||||+-||||||+-||||||+-||||||+-||||||+-||||||+-
|||||||0|||||||1|||||||2|||||||3|||||||4|||||||5|||||||6|||||||7|||||||8|||||||9|||||||A|||||||B|||||||C|||||||D|||||||E|||||||F
6-------6-------6-------6-------6-------6-------6-------6-------6-------6-------6-------6-------6-------6-------6-------6-------
|+------|+------|+------|+------|+------|+------|+------|+------|+------|+------|+------|+------|+------|+------|+------|+------
||+-----||+-----||+-----||+-----||+-----||+-----||+-----||+-----||+-----||+-----||+-----||+-----||+-----||+-----||+-----||+-----
|||+----|||+----|||+----|||+----|||+----|||+----|||+----|||+----|||+----|||+----|||+----|||+----|||+----|||+----|||+----|||+----
||||+---||||+---||||+---||||+---||||+---||||+---||||+---||||+---||||+---||||+---||||+---||||+---||||+---||||+---||||+---||||+---
|||||+--|||||+--|||||+--|||||+--|||||+--|||||+--|||||+--|||||+--|||||+--|||||+--|||||+--|||||+--|||||+--|||||+--|||||+--|||||+--
||||||+-||||||+-||||||+-||||||+-||||||+-||||||+-||||||+-||||||+-||||||+-||||||+-||||||+-||||||+-||||||+-||||||+-||||||+-||||||+-
|||||||0|||||||1|||||||2|||||||3|||||||4|||||||5|||||||6|||||||7|||||||8|||||||9|||||||A|||||||B|||||||C|||||||D|||||||E|||||||F
7-------7-------7-------7-------7-------7-------7-------7-------7-------7-------7-------7-------7-------7-------7-------7-------
|+------|+------|+------|+------|+------|+------|+------|+------|+------|+------|+------|+------|+------|+------|+------|+------
||+-----||+-----||+-----||+-----||+-----||+-----||+-----||+-----||+-----||+-----||+-----||+-----||+-----||+-----||+-----||+-----
|||+----|||+----|||+----|||+----|||+----|||+----|||+----|||+----|||+----|||+----|||+----|||+----|||+----|||+----|||+----|||+----
||||+---||||+---||||+---||||+---||||+---||||+---||||+---||||+---||||+---||||+---||||+---||||+---||||+---||||+---||||+---||||+---
|||||+--|||||+--|||||+--|||||+--|||||+--|||||+--|||||+--|||||+--|||||+--|||||+--|||||+--|||||+--|||||+--|||||+--|||||+--|||||+--
||||||+-||||||+-||||||+-||||||+-||||||+-||||||+-||||||+-||||||+-||||||+-||||||+-||||||+-||||||+-||||||+-||||||+-||||||+-||||||+-
|||||||0|||||||1|||||||2|||||||3|||||||4|||||||5|||||||6|||||||7|||||||8|||||||9|||||||A|||||||B|||||||C|||||||D|||||||E|||||||F