AAAAAAAAAAAAAAAAAAAAAAAAAAAAAAAAAAAAAAAAAAAAAAAAAAAAAAAAAAAAAAAAAAAAAAAAAAAAAAAAAAAAAAAAAAAAAAAAAAAAAAAAAAAAAAAAAAAAAAAAAAAAAAAA
ABBBBBBBABBBBBBBABBBBBBBABBBBBBBABBBBBBBABBBBBBBABBBBBBBABBBBBBBABBBBBBBABBBBBBBABBBBBBBABBBBBBBABBBBBBBABBBBBBBABBBBBBBABBBBBBB
ABCCCCCCABCCCCCCABCCCCCCABCCCCCCABCCCCCCABCCCCCCABCCCCCCABCCCCCCABCCCCCCABCCCCCCABCCCCCCABCCCCCCABCCCCCCABCCCCCCABCCCCCCABCCCCCC
ABCDDDDDABCDDDDDABCDDDDDABCDDDDDABCDDDDDABCDDDDDABCDDDDDABCDDDDDABCDDDDDABCDDDDDABCDDDDDABCDDDDDABCDDDDDABCDDDDDABCDDDDDABCDDDDD
ABCDEEEEABCDEEEEABCDEEEEABCDEEEEABCDEEEEABCDEEEEABCDEEEEABCDEEEEABCDEEEEABCDEEEEABCDEEEEABCDEEEEABCDEEEEABCDEEEEABCDEEEEABCDEEEE
ABCDEFFFABCDEFFFABCDEFFFABCDEFFFABCDEFFFABCDEFFFABCDEFFFABCDEFFFABCDEFFFABCDEFFFABCDEFFFABCDEFFFABCDEFFFABCDEFFFABCDEFFFABCDEFFF
ABCDEFGGABCDEFGGABCDEFGGABCDEFGGABCDEFGGABCDEFGGABCDEFGGABCDEFGGABCDEFGGABCDEFGGABCDEFGGABCDEFGGABCDEFGGABCDEFGGABCDEFGGABCDEFGG
ABCDEFGHABCDEFGHABCDEFGHABCDEFGHABCDEFGHABCDEFGHABCDEFGHABCDEFGHABCDEFGHABCDEFGHABCDEFGHABCDEFGHABCDEFGHABCDEFGHABCDEFGHABCDEFGH
AAAAAAAAAAAAAAAAAAAAAAAAAAAAAAAAAAAAAAAAAAAAAAAAAAAAAAAAAAAAAAAAAAAAAAAAAAAAAAAAAAAAAAAAAAAAAAAAAAAAAAAAAAAAAAAAAAAAAAAAAAAAAAAA
ABBBBBBBABBBBBBBABBBBBBBABBBBBBBABBBBBBBABBBBBBBABBBBBBBABBBBBBBABBBBBBBABBBBBBBABBBBBBBABBBBBBBABBBBBBBABBBBBBBABBBBBBBABBBBBBB
ABCCCCCCABCCCCCCABCCCCCCABCCCCCCABCCCCCCABCCCCCCABCCCCCCABCCCCCCABCCCCCCABCCCCCCABCCCCCCABCCCCCCABCCCCCCABCCCCCCABCCCCCCABCCCCCC
ABCDDDDDABCDDDDDABCDDDDDABCDDDDDABCDDDDDABCDDDDDABCDDDDDABCDDDDDABCDDDDDABCDDDDDABCDDDDDABCDDDDDABCDDDDDABCDDDDDABCDDDDDABCDDDDD
ABCDEEEEABCDEEEEABCDEEEEABCDEEEEABCDEEEEABCDEEEEABCDEEEEABCDEEEEABCDEEEEABCDEEEEABCDEEEEABCDEEEEABCDEEEEABCDEEEEABCDEEEEABCDEEEE
ABCDEFFFABCDEFFFABCDEFFFABCDEFFFABCDEFFFABCDEFFFABCDEFFFABCDEFFFABCDEFFFABCDEFFFABCDEFFFABCDEFFFABCDEFFFABCDEFFFABCDEFFFABCDEFFF
ABCDEFGGABCDEFGGABCDEFGGABCDEFGGABCDEFGGABCDEFGGABCDEFGGABCDEFGGABCDEFGGABCDEFGGABCDEFGGABCDEFGGABCDEFGGABCDEFGGABCDEFGGABCDEFGG
ABCDEFGHABCDEFGHABCDEFGHABCDEFGHABCDEFGHABCDEFGHABCDEFGHABCDEFGHABCDEFGHABCDEFGHABCDEFGHABCDEFGHABCDEFGHABCDEFGHABCDEFGHABCDEFGH
AAAAAAAAAAAAAAAAAAAAAAAAAAAAAAAAAAAAAAAAAAAAAAAAAAAAAAAAAAAAAAAAAAAAAAAAAAAAAAAAAAAAAAAAAAAAAAAAAAAAAAAAAAAAAAAAAAAAAAAAAAAAAAAA
ABBBBBBBABBBBBBBABBBBBBBABBBBBBBABBBBBBBABBBBBBBABBBBBBBABBBBBBBABBBBBBBABBBBBBBABBBBBBBABBBBBBBABBBBBBBABBBBBBBABBBBBBBABBBBBBB
ABCCCCCCABCCCCCCABCCCCCCABCCCCCCABCCCCCCABCCCCCCABCCCCCCABCCCCCCABCCCCCCABCCCCCCABCCCCCCABCCCCCCABCCCCCCABCCCCCCABCCCCCCABCCCCCC
ABCDDDDDABCDDDDDABCDDDDDABCDDDDDABCDDDDDABCDDDDDABCDDDDDABCDDDDDABCDDDDDABCDDDDDABCDDDDDABCDDDDDABCDDDDDABCDDDDDABCDDDDDABCDDDDD
ABCDEEEEABCDEEEEABCDEEEEABCDEEEEABCDEEEEABCDEEEEABCDEEEEABCDEEEEABCDEEEEABCDEEEEABCDEEEEABCDEEEEABCDEEEEABCDEEEEABCDEEEEABCDEEEE
ABCDEFFFABCDEFFFABCDEFFFABCDEFFFABCDEFFFABCDEFFFABCDEFFFABCDEFFFABCDEFFFABCDEFFFABCDEFFFABCDEFFFABCDEFFFABCDEFFFABCDEFFFABCDEFFF
ABCDEFGGABCDEFGGABCDEFGGABCDEFGGABCDEFGGABCDEFGGABCDEFGGABCDEFGGABCDEFGGABCDEFGGABCDEFGGABCDEFGGABCDEFGGABCDEFGGABCDEFGGABCDEFGG
ABCDEFGHABCDEFGHABCDEFGHABCDEFGHABCDEFGHABCDEFGHABCDEFGHABCDEFGHABCDEFGHABCDEFGHABCDEFGHABCDEFGHABCDEFGHABCDEFGHABCDEFGHABCDEFGH
AAAAAAAAAAAAAAAAAAAAAAAAAAAAAAAAAAAAAAAAAAAAAAAAAAAAAAAAAAAAAAAAAAAAAAAAAAAAAAAAAAAAAAAAAAAAAAAAAAAAAAAAAAAAAAAAAAAAAAAAAAAAAAAA
ABBBBBBBABBBBBBBABBBBBBBABBBBBBBABBBBBBBABBBBBBBABBBBBBBABBBBBBBABBBBBBBABBBBBBBABBBBBBBABBBBBBBABBBBBBBABBBBBBBABBBBBBBABBBBBBB
ABCCCCCCABCCCCCCABCCCCCCABCCCCCCABCCCCCCABCCCCCCABCCCCCCABCCCCCCABCCCCCCABCCCCCCABCCCCCCABCCCCCCABCCCCCCABCCCCCCABCCCCCCABCCCCCC
ABCDDDDDABCDDDDDABCDDDDDABCDDDDDABCDDDDDABCDDDDDABCDDDDDABCDDDDDABCDDDDDABCDDDDDABCDDDDDABCDDDDDABCDDDDDABCDDDDDABCDDDDDABCDDDDD
ABCDEEEEABCDEEEEABCDEEEEABCDEEEEABCDEEEEABCDEEEEABCDEEEEABCDEEEEABCDEEEEABCDEEEEABCDEEEEABCDEEEEABCDEEEEABCDEEEEABCDEEEEABCDEEEE
ABCDEFFFABCDEFFFABCDEFFFABCDEFFFABCDEFFFABCDEFFFABCDEFFFABCDEFFFABCDEFFFABCDEFFFABCDEFFFABCDEFFFABCDEFFFABCDEFFFABCDEFFFABCDEFFF
ABCDEFGGABCDEFGGABCDEFGGABCDEFGGABCDEFGGABCDEFGGABCDEFGGABCDEFGGABCDEFGGABCDEFGGABCDEFGGABCDEFGGABCDEFGGABCDEFGGABCDEFGGABCDEFGG
ABCDEFGHABCDEFGHABCDEFGHABCDEFGHABCDEFGHABCDEFGHABCDEFGHABCDEFGHABCDEFGHABCDEFGHABCDEFGHABCDEFGHABCDEFGHABCDEFGHABCDEFGHABCDEFGH
AAAAAAAAAAAAAAAAAAAAAAAAAAAAAAAAAAAAAAAAAAAAAAAAAAAAAAAAAAAAAAAAAAAAAAAAAAAAAAAAAAAAAAAAAAAAAAAAAAAAAAAAAAAAAAAAAAAAAAAAAAAAAAAA
ABBBBBBBABBBBBBBABBBBBBBABBBBBBBABBBBBBBABBBBBBBABBBBBBBABBBBBBBABBBBBBBABBBBBBBABBBBBBBABBBBBBBABBBBBBBABBBBBBBABBBBBBBABBBBBBB
ABCCCCCCABCCCCCCABCCCCCCABCCCCCCABCCCCCCABCCCCCCABCCCCCCABCCCCCCABCCCCCCABCCCCCCABCCCCCCABCCCCCCABCCCCCCABCCCCCCABCCCCCCABCCCCCC
ABCDDDDDABCDDDDDABCDDDDDABCDDDDDABCDDDDDABCDDDDDABCDDDDDABCDDDDDABCDDDDDABCDDDDDABCDDDDDABCDDDDDABCDDDDDABCDDDDDABCDDDDDABCDDDDD
ABCDEEEEABCDEEEEABCDEEEEABCDEEEEABCDEEEEABCDEEEEABCDEEEEABCDEEEEABCDEEEEABCDEEEEABCDEEEEABCDEEEEABCDEEEEABCDEEEEABCDEEEEABCDEEEE
ABCDEFFFABCDEFFFABCDEFFFABCDEFFFABCDEFFFABCDEFFFABCDEFFFABCDEFFFABCDEFFFABCDEFFFABCDEFFFABCDEFFFABCDEFFFABCDEFFFABCDEFFFABCDEFFF
ABCDEFGGABCDEFGGABCDEFGGABCDEFGGABCDEFGGABCDEFGGABCDEFGGABCDEFGGABCDEFGGABCDEFGGABCDEFGGABCDEFGGABCDEFGGABCDEFGGABCDEFGGABCDEFGG
ABCDEFGHABCDEFGHABCDEFGHABCDEFGHABCDEFGHABCDEFGHABCDEFGHABCDEFGHABCDEFGHABCDEFGHABCDEFGHABCDEFGHABCDEFGHABCDEFGHABCDEFGHABCDEFGH
AAAAAAAAAAAAAAAAAAAAAAAAAAAAAAAAAAAAAAAAAAAAAAAAAAAAAAAAAAAAAAAAAAAAAAAAAAAAAAAAAAAAAAAAAAAAAAAAAAAAAAAAAAAAAAAAAAAAAAAAAAAAAAAA
ABBBBBBBABBBBBBBABBBBBBBABBBBBBBABBBBBBBABBBBBBBABBBBBBBABBBBBBBABBBBBBBABBBBBBBABBBBBBBABBBBBBBABBBBBBBABBBBBBBABBBBBBBABBBBBBB
ABCCCCCCABCCCCCCABCCCCCCABCCCCCCABCCCCCCABCCCCCCABCCCCCCABCCCCCCABCCCCCCABCCCCCCABCCCCCCABCCCCCCABCCCCCCABCCCCCCABCCCCCCABCCCCCC
ABCDDDDDABCDDDDDABCDDDDDABCDDDDDABCDDDDDABCDDDDDABCDDDDDABCDDDDDABCDDDDDABCDDDDDABCDDDDDABCDDDDDABCDDDDDABCDDDDDABCDDDDDABCDDDDD
ABCDEEEEABCDEEEEABCDEEEEABCDEEEEABCDEEEEABCDEEEEABCDEEEEABCDEEEEABCDEEEEABCDEEEEABCDEEEEABCDEEEEABCDEEEEABCDEEEEABCDEEEEABCDEEEE
ABCDEFFFABCDEFFFABCDEFFFABCDEFFFABCDEFFFABCDEFFFABCDEFFFABCDEFFFABCDEFFFABCDEFFFABCDEFFFABCDEFFFABCDEFFFABCDEFFFABCDEFFFABCDEFFF
ABCDEFGGABCDEFGGABCDEFGGABCDEFGGABCDEFGGABCDEFGGABCDEFGGABCDEFGGABCDEFGGABCDEFGGABCDEFGGABCDEFGGABCDEFGGABCDEFGGABCDEFGGABCDEFGG
ABCDEFGHABCDEFGHABCDEFGHABCDEFGHABCDEFGHABCDEFGHABCDEFGHABCDEFGHABCDEFGHABCDEFGHABCDEFGHABCDEFGHABCDEFGHABCDEFGHABCDEFGHABCDEFGH
AAAAAAAAAAAAAAAAAAAAAAAAAAAAAAAAAAAAAAAAAAAAAAAAAAAAAAAAAAAAAAAAAAAAAAAAAAAAAAAAAAAAAAAAAAAAAAAAAAAAAAAAAAAAAAAAAAAAAAAAAAAAAAAA
ABBBBBBBABBBBBBBABBBBBBBABBBBBBBABBBBBBBABBBBBBBABBBBBBBABBBBBBBABBBBBBBABBBBBBBABBBBBBBABBBBBBBABBBBBBBABBBBBBBABBBBBBBABBBBBBB
ABCCCCCCABCCCCCCABCCCCCCABCCCCCCABCCCCCCABCCCCCCABCCCCCCABCCCCCCABCCCCCCABCCCCCCABCCCCCCABCCCCCCABCCCCCCABCCCCCCABCCCCCCABCCCCCC
ABCDDDDDABCDDDDDABCDDDDDABCDDDDDABCDDDDDABCDDDDDABCDDDDDABCDDDDDABCDDDDDABCDDDDDABCDDDDDABCDDDDDABCDDDDDABCDDDDDABCDDDDDABCDDDDD
ABCDEEEEABCDEEEEABCDEEEEABCDEEEEABCDEEEEABCDEEEEABCDEEEEABCDEEEEABCDEEEEABCDEEEEABCDEEEEABCDEEEEABCDEEEEABCDEEEEABCDEEEEABCDEEEE
ABCDEFFFABCDEFFFABCDEFFFABCDEFFFABCDEFFFABCDEFFFABCDEFFFABCDEFFFABCDEFFFABCDEFFFABCDEFFFABCDEFFFABCDEFFFABCDEFFFABCDEFFFABCDEFFF
ABCDEFGGABCDEFGGABCDEFGGABCDEFGGABCDEFGGABCDEFGGABCDEFGGABCDEFGGABCDEFGGABCDEFGGABCDEFGGABCDEFGGABCDEFGGABCDEFGGABCDEFGGABCDEFGG
ABCDEFGHABCDEFGHABCDEFGHABCDEFGHABCDEFGHABCDEFGHABCDEFGHABCDEFGHABCDEFGHABCDEFGHABCDEFGHABCDEFGHABCDEFGHABCDEFGHABCDEFGHABCDEFGH
AAAAAAAAAAAAAAAAAAAAAAAAAAAAAAAAAAAAAAAAAAAAAAAAAAAAAAAAAAAAAAAAAAAAAAAAAAAAAAAAAAAAAAAAAAAAAAAAAAAAAAAAAAAAAAAAAAAAAAAAAAAAAAAA
ABBBBBBBABBBBBBBABBBBBBBABBBBBBBABBBBBBBABBBBBBBABBBBBBBABBBBBBBABBBBBBBABBBBBBBABBBBBBBABBBBBBBABBBBBBBABBBBBBBABBBBBBBABBBBBBB
ABCCCCCCABCCCCCCABCCCCCCABCCCCCCABCCCCCCABCCCCCCABCCCCCCABCCCCCCABCCCCCCABCCCCCCABCCCCCCABCCCCCCABCCCCCCABCCCCCCABCCCCCCABCCCCCC
ABCDDDDDABCDDDDDABCDDDDDABCDDDDDABCDDDDDABCDDDDDABCDDDDDABCDDDDDABCDDDDDABCDDDDDABCDDDDDABCDDDDDABCDDDDDABCDDDDDABCDDDDDABCDDDDD
ABCDEEEEABCDEEEEABCDEEEEABCDEEEEABCDEEEEABCDEEEEABCDEEEEABCDEEEEABCDEEEEABCDEEEEABCDEEEEABCDEEEEABCDEEEEABCDEEEEABCDEEEEABCDEEEE
ABCDEFFFABCDEFFFABCDEFFFABCDEFFFABCDEFFFABCDEFFFABCDEFFFABCDEFFFABCDEFFFABCDEFFFABCDEFFFABCDEFFFABCDEFFFABCDEFFFABCDEFFFABCDEFFF
ABCDEFGGABCDEFGGABCDEFGGABCDEFGGABCDEFGGABCDEFGGABCDEFGGABCDEFGGABCDEFGGABCDEFGGABCDEFGGABCDEFGGABCDEFGGABCDEFGGABCDEFGGABCDEFGG
ABCDEFGHABCDEFGHABCDEFGHABCDEFGHABCDEFGHABCDEFGHABCDEFGHABCDEFGHABCDEFGHABCDEFGHABCDEFGHABCDEFGHABCDEFGHABCDEFGHABCDEFGHABCDEFGH
