32
64
<>                                                              
<><>                                                            
<>  <>                                                          
<><><><>                                                        
<>      <>                                                      
<><>    <><>                                                    
<>  <>  <>  <>                                                  
<><><><><><><><>                                                
<>              <>                                              
<><>            <><>                                            
<>  <>          <>  <>                                          
<><><><>        <><><><>                                        
<>      <>      <>      <>                                      
<><>    <><>    <><>    <><>                                    
<>  <>  <>  <>  <>  <>  <>  <>                                  
<><><><><><><><><><><><><><><><>                                
<>                              <>                              
<><>                            <><>                            
<>  <>                          <>  <>                          
<><><><>                        <><><><>                        
<>      <>                      <>      <>                      
<><>    <><>                    <><>    <><>                    
<>  <>  <>  <>                  <>  <>  <>  <>                  
<><><><><><><><>                <><><><><><><><>                
<>              <>              <>              <>              
<><>            <><>            <><>            <><>            
<>  <>          <>  <>          <>  <>          <>  <>          
<><><><>        <><><><>        <><><><>        <><><><>        
<>      <>      <>      <>      <>      <>      <>      <>      
<><>    <><>    <><>    <><>    <><>    <><>    <><>    <><>    
<>  <>  <>  <>  <>  <>  <>  <>  <>  <>  <>  <>  <>  <>  <>  <>  
<><><><><><><><><><><><><><><><><><><><><><><><><><><><><><><><>